15 60
############################################################
# #      #       ## ########################################
# ###### # ########                        #              ##
#        # #        # ###################### ###############
# # ###### # ######## #     #      ###     # ###########   #
# #        # ######## # ### # # ## ### ##### #       ### ###
# ########## ######## # ### ### ## #           # #####     #
# #          ######## # ### #   ## # ######### # ##### ## ##
# # ##########        # ### # #### #         # #       ## ##
# # ########## ######## ### #    # # ######### #############
# # #                   ### #### # # #              ##     #
# # # ##################### #    # # # ####### #### ## #####
# # # ######     ########## # #### ### # ##### #### ## #####
#   #        #####            ####     #       ####        #
############################################################