6 6
######
#    #
# ## #
# #  #
# ## #
######