11 60
############################################################
#                                     #                    #
######################## ############## ################## #
#                  #   # #            # ########           #
# # ################ # # # ############ #      #############
# #        #         # # # #            # ###### #         #
# #################### # # # # ########## #### # # #########
#                      # # # #                 #           #
###################### # # # # ################# ###########
#                            #                             #
############################################################